0 0 0 0 0 0 0 0 0 0 0 0 0 0 0 0 0 0 0 0 0 0 0 0 0 0 0 0
0 0 0 0 0 0 0 0 0 0 0 0 0 0 0 0 0 0 0 0 0 0 0 0 0 0 0 0
100 100 102 102 102 100 100 100 103 103 103 100 100 0 0 100 100 100 100 100 100 100 100 100 100 100 100 100
100 1 1 1 1 1 1 1 1 1 1 1 100 0 0 100 1 1 1 1 2 1 1 1 100 1 1 100
100 1 100 1 100 100 100 100 100 1 1 100 100 0 0 100 1 100 100 1 100 100 100 1 100 1 100 100
100 1 100 2 100 1 1 1 1 1 2 1 100 0 0 100 100 100 1 1 100 3 100 1 1 1 100 100
100 1 100 100 100 1 1 100 100 1 100 100 100 0 0 100 1 100 1 1 100 101 100 1 1 100 100 100
100 1 1 1 1 1 0 1 1 1 1 100 100 0 0 100 1 1 1 1 1 1 2 1 1 1 4 100
100 100 100 1 2 100 1 1 1 1 100 100 100 0 0 100 100 1 1 1 100 1 100 100 100 1 1 100
100 1 1 1 100 100 100 1 1 1 1 1 100 0 0 100 2 1 100 100 100 1 1 2 1 1 100 100
100 1 2 1 1 100 1 1 100 100 100 100 100 0 0 100 1 1 1 1 100 100 100 1 100 1 1 100
100 1 100 100 1 1 1 1 100 1 1 1 100 0 0 100 100 100 1 2 1 1 1 1 100 100 1 100
100 1 1 100 100 1 1 100 100 1 100 1 100 0 0 100 1 100 1 1 100 1 100 1 1 100 1 100
100 100 1 1 1 1 1 2 1 1 100 1 100 0 0 100 1 1 1 1 100 1 100 1 1 1 1 100
100 100 100 100 100 100 100 100 100 100 100 100 100 0 0 100 100 202 202 202 100 100 100 203 203 203 100 100